++++++++++++++++++++++++++++++++++++++++++++++
+ s             +                            +
+  ++++++++++  +++++++++++++  +++++++  ++++  +
+           +                 +        +     +
+  +++++++  +++++++++++++  +++++++++++++++++++
+  +     +  +           +  +                 +
+  +  +  +  +  +  ++++  +  +  +++++++++++++  +
+  +  +  +  +  +  +     +  +  +  +        +  +
+  +  ++++  +  ++++++++++  +  +  ++++  +  +  +
+  +     +  +              +           +  +  +
+  ++++  +  ++++++++++++++++  +++++++++++++  +
+     +  +                    +              +
++++  +  ++++++++++++++++++++++  ++++++++++  +
+  +  +                    +     +     +  +  +
+  +  ++++  +++++++++++++  +  ++++  +  +  +  +
+  +  +     +     +     +  +  +     +     +  +
+  +  +  +++++++  ++++  +  +  +  ++++++++++  +
+                       +  +  +              +
++++  +  +  ++++++++++  +  +  +  +++++++++++++
+++++++++++++++++++++++e++++++++++++++++++++++

